"filename", "language", "Dart", "comment", "blank", "total"
"v:\GitHub\los_angeles_quests\lib\constants\paths.dart", "Dart", 115, 0, 30, 145
"v:\GitHub\los_angeles_quests\lib\constants\size_utils.dart", "Dart", 28, 0, 2, 30
"v:\GitHub\los_angeles_quests\lib\constants\ui_constants.dart", "Dart", 221, 2, 29, 252
"v:\GitHub\los_angeles_quests\lib\constants\utils.dart", "Dart", 112, 4, 20, 136
"v:\GitHub\los_angeles_quests\lib\core\connectivity_service.dart", "Dart", 19, 0, 5, 24
"v:\GitHub\los_angeles_quests\lib\core\custom_cache_manager.dart", "Dart", 23, 0, 6, 29
"v:\GitHub\los_angeles_quests\lib\core\error\exception.dart", "Dart", 8, 0, 8, 16
"v:\GitHub\los_angeles_quests\lib\core\error\failure.dart", "Dart", 14, 0, 11, 25
"v:\GitHub\los_angeles_quests\lib\core\fade_in_route.dart", "Dart", 20, 0, 3, 23
"v:\GitHub\los_angeles_quests\lib\core\formatters\card_number_formatter.dart", "Dart", 31, 1, 6, 38
"v:\GitHub\los_angeles_quests\lib\core\formatters\cvv_input_formatter.dart", "Dart", 17, 0, 4, 21
"v:\GitHub\los_angeles_quests\lib\core\formatters\date_input_formatter.dart", "Dart", 31, 2, 7, 40
"v:\GitHub\los_angeles_quests\lib\core\formatters\phone_number_formatter.dart", "Dart", 51, 5, 8, 64
"v:\GitHub\los_angeles_quests\lib\core\formatters\upper_case_text_formatter.dart", "Dart", 11, 0, 2, 13
"v:\GitHub\los_angeles_quests\lib\core\language_cubit\language_cubit_cubit.dart", "Dart", 10, 0, 3, 13
"v:\GitHub\los_angeles_quests\lib\core\params\authentification_param.dart", "Dart", 11, 0, 4, 15
"v:\GitHub\los_angeles_quests\lib\core\params\no_param.dart", "Dart", 1, 0, 1, 2
"v:\GitHub\los_angeles_quests\lib\core\platform\network_info.dart", "Dart", 11, 0, 5, 16
"v:\GitHub\los_angeles_quests\lib\core\routes.dart", "Dart", 63, 0, 2, 65
"v:\GitHub\los_angeles_quests\lib\core\shared_preferences_helper.dart", "Dart", 22, 0, 8, 30
"v:\GitHub\los_angeles_quests\lib\core\shared_preferences_keys.dart", "Dart", 6, 0, 1, 7
"v:\GitHub\los_angeles_quests\lib\core\usecases\usecase.dart", "Dart", 5, 0, 2, 7
"v:\GitHub\los_angeles_quests\lib\core\web_socket_service.dart", "Dart", 35, 0, 7, 42
"v:\GitHub\los_angeles_quests\lib\features\data\datasources\auth_remote_data_source_impl.dart", "Dart", 143, 0, 26, 169
"v:\GitHub\los_angeles_quests\lib\features\data\datasources\category_remote_data_source_impl.dart", "Dart", 83, 0, 17, 100
"v:\GitHub\los_angeles_quests\lib\features\data\datasources\chat_remote_data_source_impl.dart", "Dart", 67, 0, 11, 78
"v:\GitHub\los_angeles_quests\lib\features\data\datasources\file_remote_data_source_impl.dart", "Dart", 61, 6, 15, 82
"v:\GitHub\los_angeles_quests\lib\features\data\datasources\person_remote_data_source_impl.dart", "Dart", 86, 0, 17, 103
"v:\GitHub\los_angeles_quests\lib\features\data\datasources\quest_remote_data_source_impl.dart", "Dart", 128, 7, 30, 165
"v:\GitHub\los_angeles_quests\lib\features\data\datasources\user_remote_data_source_impl.dart", "Dart", 97, 0, 17, 114
"v:\GitHub\los_angeles_quests\lib\features\data\datasources\web_socket_remote_data_source_impl.dart", "Dart", 55, 3, 13, 71
"v:\GitHub\los_angeles_quests\lib\features\data\models\category_model.dart", "Dart", 18, 0, 5, 23
"v:\GitHub\los_angeles_quests\lib\features\data\models\chat_model.dart", "Dart", 55, 0, 9, 64
"v:\GitHub\los_angeles_quests\lib\features\data\models\message_model.dart", "Dart", 46, 0, 5, 51
"v:\GitHub\los_angeles_quests\lib\features\data\models\notification_model.dart", "Dart", 73, 0, 13, 86
"v:\GitHub\los_angeles_quests\lib\features\data\models\person_model.dart", "Dart", 66, 0, 5, 71
"v:\GitHub\los_angeles_quests\lib\features\data\models\quest_parameter_model.dart", "Dart", 13, 0, 5, 18
"v:\GitHub\los_angeles_quests\lib\features\data\models\user_model.dart", "Dart", 51, 0, 5, 56
"v:\GitHub\los_angeles_quests\lib\features\data\repositories\auth_repository_impl.dart", "Dart", 66, 0, 11, 77
"v:\GitHub\los_angeles_quests\lib\features\data\repositories\category_repository_impl.dart", "Dart", 50, 0, 6, 56
"v:\GitHub\los_angeles_quests\lib\features\data\repositories\chat_repository_impl.dart", "Dart", 41, 0, 5, 46
"v:\GitHub\los_angeles_quests\lib\features\data\repositories\file_repository_impl.dart", "Dart", 37, 0, 5, 42
"v:\GitHub\los_angeles_quests\lib\features\data\repositories\person_repository_impl.dart", "Dart", 65, 0, 7, 72
"v:\GitHub\los_angeles_quests\lib\features\data\repositories\quest_repository_impl.dart", "Dart", 88, 0, 13, 101
"v:\GitHub\los_angeles_quests\lib\features\data\repositories\user_repository_impl.dart", "Dart", 54, 0, 6, 60
"v:\GitHub\los_angeles_quests\lib\features\data\repositories\web_socket_repository_impl.dart", "Dart", 54, 0, 7, 61
"v:\GitHub\los_angeles_quests\lib\features\domain\entities\category_entity.dart", "Dart", 13, 0, 4, 17
"v:\GitHub\los_angeles_quests\lib\features\domain\entities\chat_entity.dart", "Dart", 27, 0, 7, 34
"v:\GitHub\los_angeles_quests\lib\features\domain\entities\message_entity.dart", "Dart", 22, 0, 4, 26
"v:\GitHub\los_angeles_quests\lib\features\domain\entities\notification_entity.dart", "Dart", 31, 0, 10, 41
"v:\GitHub\los_angeles_quests\lib\features\domain\entities\person_entity.dart", "Dart", 40, 0, 4, 44
"v:\GitHub\los_angeles_quests\lib\features\domain\entities\quest_parameter_entity.dart", "Dart", 8, 0, 4, 12
"v:\GitHub\los_angeles_quests\lib\features\domain\entities\user_entity.dart", "Dart", 24, 0, 4, 28
"v:\GitHub\los_angeles_quests\lib\features\domain\repositories\auth_repository.dart", "Dart", 14, 0, 2, 16
"v:\GitHub\los_angeles_quests\lib\features\domain\repositories\category_repository.dart", "Dart", 9, 0, 2, 11
"v:\GitHub\los_angeles_quests\lib\features\domain\repositories\chat_repository.dart", "Dart", 10, 0, 2, 12
"v:\GitHub\los_angeles_quests\lib\features\domain\repositories\file_repository.dart", "Dart", 7, 0, 3, 10
"v:\GitHub\los_angeles_quests\lib\features\domain\repositories\person_repository.dart", "Dart", 12, 0, 2, 14
"v:\GitHub\los_angeles_quests\lib\features\domain\repositories\quest_repository.dart", "Dart", 14, 0, 2, 16
"v:\GitHub\los_angeles_quests\lib\features\domain\repositories\user_repository.dart", "Dart", 13, 0, 2, 15
"v:\GitHub\los_angeles_quests\lib\features\domain\repositories\web_socket_repository.dart", "Dart", 10, 0, 2, 12
"v:\GitHub\los_angeles_quests\lib\features\domain\usecases\auth\auth_login.dart", "Dart", 14, 0, 4, 18
"v:\GitHub\los_angeles_quests\lib\features\domain\usecases\auth\auth_register.dart", "Dart", 13, 0, 4, 17
"v:\GitHub\los_angeles_quests\lib\features\domain\usecases\auth\get_verification_code.dart", "Dart", 13, 0, 4, 17
"v:\GitHub\los_angeles_quests\lib\features\domain\usecases\auth\reload_token.dart", "Dart", 13, 0, 4, 17
"v:\GitHub\los_angeles_quests\lib\features\domain\usecases\auth\reset_password.dart", "Dart", 13, 0, 4, 17
"v:\GitHub\los_angeles_quests\lib\features\domain\usecases\auth\verify_code.dart", "Dart", 14, 0, 4, 18
"v:\GitHub\los_angeles_quests\lib\features\domain\usecases\auth\verify_reset_password.dart", "Dart", 14, 0, 4, 18
"v:\GitHub\los_angeles_quests\lib\features\domain\usecases\category\create_category.dart", "Dart", 13, 0, 4, 17
"v:\GitHub\los_angeles_quests\lib\features\domain\usecases\category\get_all_categories.dart", "Dart", 14, 0, 4, 18
"v:\GitHub\los_angeles_quests\lib\features\domain\usecases\category\update_category.dart", "Dart", 13, 0, 4, 17
"v:\GitHub\los_angeles_quests\lib\features\domain\usecases\chat\get_all_chats.dart", "Dart", 14, 0, 4, 18
"v:\GitHub\los_angeles_quests\lib\features\domain\usecases\chat\get_chat_messages.dart", "Dart", 25, 0, 7, 32
"v:\GitHub\los_angeles_quests\lib\features\domain\usecases\file\get_file.dart", "Dart", 12, 0, 4, 16
"v:\GitHub\los_angeles_quests\lib\features\domain\usecases\file\upload_file.dart", "Dart", 13, 0, 5, 18
"v:\GitHub\los_angeles_quests\lib\features\domain\usecases\person\delete_me.dart", "Dart", 13, 0, 4, 17
"v:\GitHub\los_angeles_quests\lib\features\domain\usecases\person\get_me.dart", "Dart", 14, 0, 4, 18
"v:\GitHub\los_angeles_quests\lib\features\domain\usecases\person\get_notifications.dart", "Dart", 24, 0, 7, 31
"v:\GitHub\los_angeles_quests\lib\features\domain\usecases\person\update_me.dart", "Dart", 13, 0, 4, 17
"v:\GitHub\los_angeles_quests\lib\features\domain\usecases\purchase_use_case.dart", "Dart", 11, 0, 5, 16
"v:\GitHub\los_angeles_quests\lib\features\domain\usecases\quest\create_quest.dart", "Dart", 12, 0, 4, 16
"v:\GitHub\los_angeles_quests\lib\features\domain\usecases\quest\get_all_quests.dart", "Dart", 13, 0, 4, 17
"v:\GitHub\los_angeles_quests\lib\features\domain\usecases\quest\get_levels.dart", "Dart", 15, 0, 4, 19
"v:\GitHub\los_angeles_quests\lib\features\domain\usecases\quest\get_miles.dart", "Dart", 15, 0, 4, 19
"v:\GitHub\los_angeles_quests\lib\features\domain\usecases\quest\get_places.dart", "Dart", 15, 0, 4, 19
"v:\GitHub\los_angeles_quests\lib\features\domain\usecases\quest\get_prices.dart", "Dart", 15, 0, 4, 19
"v:\GitHub\los_angeles_quests\lib\features\domain\usecases\quest\get_quest.dart", "Dart", 12, 0, 4, 16
"v:\GitHub\los_angeles_quests\lib\features\domain\usecases\quest\get_vehicles.dart", "Dart", 15, 0, 4, 19
"v:\GitHub\los_angeles_quests\lib\features\domain\usecases\quest\update_quest.dart", "Dart", 20, 0, 7, 27
"v:\GitHub\los_angeles_quests\lib\features\domain\usecases\user\ban_user.dart", "Dart", 12, 0, 4, 16
"v:\GitHub\los_angeles_quests\lib\features\domain\usecases\user\delete_user.dart", "Dart", 12, 0, 4, 16
"v:\GitHub\los_angeles_quests\lib\features\domain\usecases\user\get_all_users.dart", "Dart", 31, 0, 7, 38
"v:\GitHub\los_angeles_quests\lib\features\domain\usecases\websocket\connect_web_socket.dart", "Dart", 34, 0, 13, 47
"v:\GitHub\los_angeles_quests\lib\features\presentation\bloc\audioplayer_bloc.dart", "Dart", 68, 0, 9, 77
"v:\GitHub\los_angeles_quests\lib\features\presentation\bloc\audioplayer_event.dart", "Dart", 16, 0, 8, 24
"v:\GitHub\los_angeles_quests\lib\features\presentation\bloc\audioplayer_state.dart", "Dart", 14, 0, 7, 21
"v:\GitHub\los_angeles_quests\lib\features\presentation\bloc\purchase_cubit.dart", "Dart", 29, 0, 12, 41
"v:\GitHub\los_angeles_quests\lib\features\presentation\pages\admin\category_create_screen\category_create_screen.dart", "Dart", 100, 0, 6, 106
"v:\GitHub\los_angeles_quests\lib\features\presentation\pages\admin\category_create_screen\components\category_quests_view.dart", "Dart", 119, 0, 4, 123
"v:\GitHub\los_angeles_quests\lib\features\presentation\pages\admin\category_create_screen\cubit\category_create_screen_cubit.dart", "Dart", 135, 0, 22, 157
"v:\GitHub\los_angeles_quests\lib\features\presentation\pages\admin\category_create_screen\cubit\category_create_screen_state.dart", "Dart", 23, 0, 7, 30
"v:\GitHub\los_angeles_quests\lib\features\presentation\pages\admin\statistics_screen\components\empty_statistics_view.dart", "Dart", 23, 0, 3, 26
"v:\GitHub\los_angeles_quests\lib\features\presentation\pages\admin\statistics_screen\components\filter_button.dart", "Dart", 55, 0, 7, 62
"v:\GitHub\los_angeles_quests\lib\features\presentation\pages\admin\statistics_screen\components\statistics_card.dart", "Dart", 57, 0, 7, 64
"v:\GitHub\los_angeles_quests\lib\features\presentation\pages\admin\statistics_screen\components\statistics_card_body.dart", "Dart", 35, 1, 3, 39
"v:\GitHub\los_angeles_quests\lib\features\presentation\pages\admin\statistics_screen\components\statistics_card_body_item.dart", "Dart", 39, 0, 4, 43
"v:\GitHub\los_angeles_quests\lib\features\presentation\pages\admin\statistics_screen\components\statistics_card_header.dart", "Dart", 95, 0, 6, 101
"v:\GitHub\los_angeles_quests\lib\features\presentation\pages\admin\statistics_screen\components\statistics_screen_filter_body\cubit\statistics_screen_filter_body_cubit.dart", "Dart", 36, 0, 8, 44
"v:\GitHub\los_angeles_quests\lib\features\presentation\pages\admin\statistics_screen\components\statistics_screen_filter_body\cubit\statistics_screen_filter_body_state.dart", "Dart", 10, 0, 5, 15
"v:\GitHub\los_angeles_quests\lib\features\presentation\pages\admin\statistics_screen\components\statistics_screen_filter_body\statistics_screen_filter_body.dart", "Dart", 148, 0, 7, 155
"v:\GitHub\los_angeles_quests\lib\features\presentation\pages\admin\statistics_screen\cubit\statistics_screen_cubit.dart", "Dart", 30, 0, 7, 37
"v:\GitHub\los_angeles_quests\lib\features\presentation\pages\admin\statistics_screen\cubit\statistics_screen_state.dart", "Dart", 8, 0, 5, 13
"v:\GitHub\los_angeles_quests\lib\features\presentation\pages\admin\statistics_screen\statistics_screen.dart", "Dart", 115, 1, 3, 119
"v:\GitHub\los_angeles_quests\lib\features\presentation\pages\admin\statistics_screen\statistics_screen_controller.dart", "Dart", 33, 3, 2, 38
"v:\GitHub\los_angeles_quests\lib\features\presentation\pages\admin\statistics_screen\statistics_screen_data.dart", "Dart", 23, 0, 2, 25
"v:\GitHub\los_angeles_quests\lib\features\presentation\pages\admin\users_screen\components\notification_view.dart", "Dart", 27, 0, 4, 31
"v:\GitHub\los_angeles_quests\lib\features\presentation\pages\admin\users_screen\components\user_item.dart", "Dart", 108, 0, 4, 112
"v:\GitHub\los_angeles_quests\lib\features\presentation\pages\admin\users_screen\components\users_all_view.dart", "Dart", 19, 0, 4, 23
"v:\GitHub\los_angeles_quests\lib\features\presentation\pages\admin\users_screen\components\users_page_view.dart", "Dart", 23, 0, 4, 27
"v:\GitHub\los_angeles_quests\lib\features\presentation\pages\admin\users_screen\cubit\users_screen_cubit.dart", "Dart", 66, 3, 14, 83
"v:\GitHub\los_angeles_quests\lib\features\presentation\pages\admin\users_screen\cubit\users_screen_state.dart", "Dart", 30, 0, 11, 41
"v:\GitHub\los_angeles_quests\lib\features\presentation\pages\admin\users_screen\users_screen.dart", "Dart", 153, 0, 4, 157
"v:\GitHub\los_angeles_quests\lib\features\presentation\pages\common\account\account_request_credits_screen\credit_preview_view.dart", "Dart", 92, 0, 4, 96
"v:\GitHub\los_angeles_quests\lib\features\presentation\pages\common\account\account_request_credits_screen\requests_for_credits_screen.dart", "Dart", 63, 0, 3, 66
"v:\GitHub\los_angeles_quests\lib\features\presentation\pages\common\account\account_screen.dart", "Dart", 279, 1, 16, 296
"v:\GitHub\los_angeles_quests\lib\features\presentation\pages\common\account\account_screen_controller.dart", "Dart", 33, 0, 3, 36
"v:\GitHub\los_angeles_quests\lib\features\presentation\pages\common\account\components\account_chip.dart", "Dart", 36, 0, 4, 40
"v:\GitHub\los_angeles_quests\lib\features\presentation\pages\common\account\components\account_credit_page_view\account_credit_page_view.dart", "Dart", 18, 0, 3, 21
"v:\GitHub\los_angeles_quests\lib\features\presentation\pages\common\account\components\account_credit_page_view\components\credit_client_view.dart", "Dart", 87, 0, 3, 90
"v:\GitHub\los_angeles_quests\lib\features\presentation\pages\common\account\components\account_information_page_view.dart", "Dart", 217, 0, 7, 224
"v:\GitHub\los_angeles_quests\lib\features\presentation\pages\common\account\components\account_page_view.dart", "Dart", 31, 0, 4, 35
"v:\GitHub\los_angeles_quests\lib\features\presentation\pages\common\account\components\account_password_page_view.dart", "Dart", 69, 0, 4, 73
"v:\GitHub\los_angeles_quests\lib\features\presentation\pages\common\account\components\account_personal_information_page_view.dart", "Dart", 54, 0, 4, 58
"v:\GitHub\los_angeles_quests\lib\features\presentation\pages\common\account\components\account_quests_page_view.dart", "Dart", 179, 1, 7, 187
"v:\GitHub\los_angeles_quests\lib\features\presentation\pages\common\account\components\block_button.dart", "Dart", 29, 0, 4, 33
"v:\GitHub\los_angeles_quests\lib\features\presentation\pages\common\account\components\buttons\block_user_button.dart", "Dart", 16, 0, 4, 20
"v:\GitHub\los_angeles_quests\lib\features\presentation\pages\common\account\components\buttons\create_user_button.dart", "Dart", 16, 0, 4, 20
"v:\GitHub\los_angeles_quests\lib\features\presentation\pages\common\account\components\buttons\delete_button.dart", "Dart", 20, 0, 4, 24
"v:\GitHub\los_angeles_quests\lib\features\presentation\pages\common\account\components\buttons\logout_button.dart", "Dart", 26, 0, 4, 30
"v:\GitHub\los_angeles_quests\lib\features\presentation\pages\common\account\components\buttons\save_changes_button.dart", "Dart", 16, 0, 4, 20
"v:\GitHub\los_angeles_quests\lib\features\presentation\pages\common\account\components\edit_button.dart", "Dart", 24, 0, 4, 28
"v:\GitHub\los_angeles_quests\lib\features\presentation\pages\common\account\components\edit_photo_view.dart", "Dart", 36, 0, 4, 40
"v:\GitHub\los_angeles_quests\lib\features\presentation\pages\common\account\components\more_button.dart", "Dart", 28, 0, 4, 32
"v:\GitHub\los_angeles_quests\lib\features\presentation\pages\common\account\components\profile_chips_view.dart", "Dart", 29, 0, 4, 33
"v:\GitHub\los_angeles_quests\lib\features\presentation\pages\common\account\cubit\account_screen_cubit.dart", "Dart", 253, 1, 32, 286
"v:\GitHub\los_angeles_quests\lib\features\presentation\pages\common\account\cubit\account_screen_state.dart", "Dart", 8, 0, 5, 13
"v:\GitHub\los_angeles_quests\lib\features\presentation\pages\common\chat\chat_screen\chat_screen.dart", "Dart", 109, 1, 5, 115
"v:\GitHub\los_angeles_quests\lib\features\presentation\pages\common\chat\chat_screen\components\message_preview_item.dart", "Dart", 95, 0, 4, 99
"v:\GitHub\los_angeles_quests\lib\features\presentation\pages\common\chat\chat_screen\components\messages_preview_view.dart", "Dart", 34, 0, 4, 38
"v:\GitHub\los_angeles_quests\lib\features\presentation\pages\common\chat\chat_screen\components\notification_view.dart", "Dart", 27, 0, 4, 31
"v:\GitHub\los_angeles_quests\lib\features\presentation\pages\common\chat\chat_screen\cubit\chat_screen_cubit.dart", "Dart", 109, 3, 12, 124
"v:\GitHub\los_angeles_quests\lib\features\presentation\pages\common\chat\chat_screen\cubit\chat_screen_state.dart", "Dart", 36, 0, 11, 47
"v:\GitHub\los_angeles_quests\lib\features\presentation\pages\common\chat\internal_chat_screen\components\audio_player_widget.dart", "Dart", 78, 0, 6, 84
"v:\GitHub\los_angeles_quests\lib\features\presentation\pages\common\chat\internal_chat_screen\components\image_attachment.dart", "Dart", 13, 0, 4, 17
"v:\GitHub\los_angeles_quests\lib\features\presentation\pages\common\chat\internal_chat_screen\components\support_chat_message.dart", "Dart", 30, 0, 5, 35
"v:\GitHub\los_angeles_quests\lib\features\presentation\pages\common\chat\internal_chat_screen\components\support_chat_message_text.dart", "Dart", 103, 0, 5, 108
"v:\GitHub\los_angeles_quests\lib\features\presentation\pages\common\chat\internal_chat_screen\components\support_chat_text_field.dart", "Dart", 34, 0, 3, 37
"v:\GitHub\los_angeles_quests\lib\features\presentation\pages\common\chat\internal_chat_screen\components\support_message_avatar.dart", "Dart", 26, 0, 4, 30
"v:\GitHub\los_angeles_quests\lib\features\presentation\pages\common\chat\internal_chat_screen\components\triangle_painter.dart", "Dart", 19, 0, 7, 26
"v:\GitHub\los_angeles_quests\lib\features\presentation\pages\common\chat\internal_chat_screen\components\video_attachment.dart", "Dart", 21, 0, 4, 25
"v:\GitHub\los_angeles_quests\lib\features\presentation\pages\common\chat\internal_chat_screen\cubit\internal_chat_screen_cubit.dart", "Dart", 36, 0, 13, 49
"v:\GitHub\los_angeles_quests\lib\features\presentation\pages\common\chat\internal_chat_screen\cubit\internal_chat_screen_state.dart", "Dart", 31, 0, 13, 44
"v:\GitHub\los_angeles_quests\lib\features\presentation\pages\common\chat\internal_chat_screen\internal_chat_screen.dart", "Dart", 216, 3, 17, 236
"v:\GitHub\los_angeles_quests\lib\features\presentation\pages\common\quest\components\add_favotire_button.dart", "Dart", 19, 0, 3, 22
"v:\GitHub\los_angeles_quests\lib\features\presentation\pages\common\quest\components\address_body.dart", "Dart", 37, 0, 4, 41
"v:\GitHub\los_angeles_quests\lib\features\presentation\pages\common\quest\components\bag_button.dart", "Dart", 22, 0, 3, 25
"v:\GitHub\los_angeles_quests\lib\features\presentation\pages\common\quest\components\bye_quest_panel.dart", "Dart", 41, 0, 4, 45
"v:\GitHub\los_angeles_quests\lib\features\presentation\pages\common\quest\components\choose_card_body.dart", "Dart", 62, 0, 6, 68
"v:\GitHub\los_angeles_quests\lib\features\presentation\pages\common\quest\components\order_inventory_body.dart", "Dart", 44, 1, 4, 49
"v:\GitHub\los_angeles_quests\lib\features\presentation\pages\common\quest\components\quest_categories_view.dart", "Dart", 37, 0, 3, 40
"v:\GitHub\los_angeles_quests\lib\features\presentation\pages\common\quest\components\quest_category_chip.dart", "Dart", 28, 0, 4, 32
"v:\GitHub\los_angeles_quests\lib\features\presentation\pages\common\quest\components\quest_description_item.dart", "Dart", 54, 0, 3, 57
"v:\GitHub\los_angeles_quests\lib\features\presentation\pages\common\quest\components\quest_rating_view.dart", "Dart", 41, 0, 3, 44
"v:\GitHub\los_angeles_quests\lib\features\presentation\pages\common\quest\components\quest_see_map_view.dart", "Dart", 40, 0, 3, 43
"v:\GitHub\los_angeles_quests\lib\features\presentation\pages\common\quest\cubit\quest_screen_cubit.dart", "Dart", 12, 0, 5, 17
"v:\GitHub\los_angeles_quests\lib\features\presentation\pages\common\quest\cubit\quest_screen_state.dart", "Dart", 8, 0, 5, 13
"v:\GitHub\los_angeles_quests\lib\features\presentation\pages\common\quest\quest_screen.dart", "Dart", 149, 0, 3, 152
"v:\GitHub\los_angeles_quests\lib\features\presentation\pages\common\quest\quest_screen_controller.dart", "Dart", 77, 1, 4, 82
"v:\GitHub\los_angeles_quests\lib\features\presentation\pages\common\quest\reviews_screen\review_item.dart", "Dart", 157, 0, 11, 168
"v:\GitHub\los_angeles_quests\lib\features\presentation\pages\common\quest\reviews_screen\reviews_screen.dart", "Dart", 83, 0, 3, 86
"v:\GitHub\los_angeles_quests\lib\features\presentation\pages\common\quest\see_a_map_screen.dart", "Dart", 117, 1, 3, 121
"v:\GitHub\los_angeles_quests\lib\features\presentation\pages\common\quest_edit\components\credits_preferences_body.dart", "Dart", 97, 0, 5, 102
"v:\GitHub\los_angeles_quests\lib\features\presentation\pages\common\quest_edit\components\main_preferences_body.dart", "Dart", 37, 0, 4, 41
"v:\GitHub\los_angeles_quests\lib\features\presentation\pages\common\quest_edit\components\mentor_preferences_body.dart", "Dart", 25, 0, 3, 28
"v:\GitHub\los_angeles_quests\lib\features\presentation\pages\common\quest_edit\components\merch_preferences_body.dart", "Dart", 109, 0, 5, 114
"v:\GitHub\los_angeles_quests\lib\features\presentation\pages\common\quest_edit\components\quest_edit_dropdown_item.dart", "Dart", 100, 0, 5, 105
"v:\GitHub\los_angeles_quests\lib\features\presentation\pages\common\quest_edit\components\quest_edit_point_item.dart", "Dart", 98, 0, 4, 102
"v:\GitHub\los_angeles_quests\lib\features\presentation\pages\common\quest_edit\cubit\edit_quest_screen_cubit.dart", "Dart", 281, 4, 37, 322
"v:\GitHub\los_angeles_quests\lib\features\presentation\pages\common\quest_edit\cubit\edit_quest_screen_state.dart", "Dart", 39, 0, 11, 50
"v:\GitHub\los_angeles_quests\lib\features\presentation\pages\common\quest_edit\edit_quest_screen.dart", "Dart", 214, 0, 6, 220
"v:\GitHub\los_angeles_quests\lib\features\presentation\pages\common\quest_edit\edit_quest_screen_controller.dart", "Dart", 8, 0, 2, 10
"v:\GitHub\los_angeles_quests\lib\features\presentation\pages\common\quest_edit\edit_quest_screen_data.dart", "Dart", 43, 0, 6, 49
"v:\GitHub\los_angeles_quests\lib\features\presentation\pages\common\quest_edit_point\components\edit_quest_point_files_chip_by_artefact_body.dart", "Dart", 46, 0, 4, 50
"v:\GitHub\los_angeles_quests\lib\features\presentation\pages\common\quest_edit_point\components\edit_quest_point_files_chip_by_download_files_body.dart", "Dart", 51, 0, 4, 55
"v:\GitHub\los_angeles_quests\lib\features\presentation\pages\common\quest_edit_point\components\edit_quest_point_files_chip_by_ghost_body.dart", "Dart", 49, 0, 4, 53
"v:\GitHub\los_angeles_quests\lib\features\presentation\pages\common\quest_edit_point\components\edit_quest_point_files_chip_by_photo_body.dart", "Dart", 26, 0, 4, 30
"v:\GitHub\los_angeles_quests\lib\features\presentation\pages\common\quest_edit_point\components\edit_quest_point_place_chip_body.dart", "Dart", 122, 0, 8, 130
"v:\GitHub\los_angeles_quests\lib\features\presentation\pages\common\quest_edit_point\components\edit_quest_point_type_or_tools_chip_body.dart", "Dart", 27, 0, 4, 31
"v:\GitHub\los_angeles_quests\lib\features\presentation\pages\common\quest_edit_point\cubit\edit_quest_point_screen_cubit.dart", "Dart", 372, 15, 35, 422
"v:\GitHub\los_angeles_quests\lib\features\presentation\pages\common\quest_edit_point\cubit\edit_quest_point_screen_state.dart", "Dart", 8, 0, 5, 13
"v:\GitHub\los_angeles_quests\lib\features\presentation\pages\common\quest_edit_point\edit_quest_point_screen.dart", "Dart", 302, 7, 12, 321
"v:\GitHub\los_angeles_quests\lib\features\presentation\pages\common\quest_edit_point\edit_quest_point_screen_controller.dart", "Dart", 8, 0, 2, 10
"v:\GitHub\los_angeles_quests\lib\features\presentation\pages\common\quests\my_quests_screen\components\my_quests_screen_category_chip.dart", "Dart", 42, 0, 4, 46
"v:\GitHub\los_angeles_quests\lib\features\presentation\pages\common\quests\my_quests_screen\cubit\my_quests_screen_cubit.dart", "Dart", 12, 0, 5, 17
"v:\GitHub\los_angeles_quests\lib\features\presentation\pages\common\quests\my_quests_screen\cubit\my_quests_screen_state.dart", "Dart", 8, 0, 5, 13
"v:\GitHub\los_angeles_quests\lib\features\presentation\pages\common\quests\my_quests_screen\my_quests_screen.dart", "Dart", 202, 1, 7, 210
"v:\GitHub\los_angeles_quests\lib\features\presentation\pages\common\quests\quests_screen\components\categories_view.dart", "Dart", 52, 0, 4, 56
"v:\GitHub\los_angeles_quests\lib\features\presentation\pages\common\quests\quests_screen\components\category_item.dart", "Dart", 84, 0, 4, 88
"v:\GitHub\los_angeles_quests\lib\features\presentation\pages\common\quests\quests_screen\components\favorite_view.dart", "Dart", 25, 0, 4, 29
"v:\GitHub\los_angeles_quests\lib\features\presentation\pages\common\quests\quests_screen\components\filter_view.dart", "Dart", 38, 0, 4, 42
"v:\GitHub\los_angeles_quests\lib\features\presentation\pages\common\quests\quests_screen\components\quest_chip.dart", "Dart", 24, 0, 4, 28
"v:\GitHub\los_angeles_quests\lib\features\presentation\pages\common\quests\quests_screen\components\quest_item.dart", "Dart", 107, 0, 4, 111
"v:\GitHub\los_angeles_quests\lib\features\presentation\pages\common\quests\quests_screen\components\quests_screen_filter_body\cubit\quests_screen_filter_body_cubit.dart", "Dart", 34, 0, 8, 42
"v:\GitHub\los_angeles_quests\lib\features\presentation\pages\common\quests\quests_screen\components\quests_screen_filter_body\cubit\quests_screen_filter_body_state.dart", "Dart", 8, 0, 5, 13
"v:\GitHub\los_angeles_quests\lib\features\presentation\pages\common\quests\quests_screen\components\quests_screen_filter_body\quests_screen_filter_body.dart", "Dart", 97, 0, 5, 102
"v:\GitHub\los_angeles_quests\lib\features\presentation\pages\common\quests\quests_screen\components\quests_small_view.dart", "Dart", 138, 0, 4, 142
"v:\GitHub\los_angeles_quests\lib\features\presentation\pages\common\quests\quests_screen\components\quests_view.dart", "Dart", 25, 0, 4, 29
"v:\GitHub\los_angeles_quests\lib\features\presentation\pages\common\quests\quests_screen\cubit\quests_screen_cubit.dart", "Dart", 77, 4, 21, 102
"v:\GitHub\los_angeles_quests\lib\features\presentation\pages\common\quests\quests_screen\cubit\quests_screen_state.dart", "Dart", 49, 0, 11, 60
"v:\GitHub\los_angeles_quests\lib\features\presentation\pages\common\quests\quests_screen\quest_screen_data.dart", "Dart", 64, 0, 2, 66
"v:\GitHub\los_angeles_quests\lib\features\presentation\pages\common\quests\quests_screen\quests_screen.dart", "Dart", 154, 6, 5, 165
"v:\GitHub\los_angeles_quests\lib\features\presentation\pages\common\quests\quests_screen\quests_screen_controller.dart", "Dart", 103, 3, 8, 114
"v:\GitHub\los_angeles_quests\lib\features\presentation\pages\common\settings\location_screen\cubit\password_screen_cubit.dart", "Dart", 6, 0, 3, 9
"v:\GitHub\los_angeles_quests\lib\features\presentation\pages\common\settings\location_screen\cubit\password_screen_state.dart", "Dart", 8, 0, 5, 13
"v:\GitHub\los_angeles_quests\lib\features\presentation\pages\common\settings\location_screen\location_screen.dart", "Dart", 121, 1, 4, 126
"v:\GitHub\los_angeles_quests\lib\features\presentation\pages\common\settings\password_screen\cubit\password_screen_cubit.dart", "Dart", 6, 0, 3, 9
"v:\GitHub\los_angeles_quests\lib\features\presentation\pages\common\settings\password_screen\cubit\password_screen_state.dart", "Dart", 8, 0, 5, 13
"v:\GitHub\los_angeles_quests\lib\features\presentation\pages\common\settings\password_screen\password_screen.dart", "Dart", 101, 1, 4, 106
"v:\GitHub\los_angeles_quests\lib\features\presentation\pages\common\settings\payment_screen\components\add_new_card_body.dart", "Dart", 101, 0, 4, 105
"v:\GitHub\los_angeles_quests\lib\features\presentation\pages\common\settings\payment_screen\components\card_view.dart", "Dart", 53, 0, 4, 57
"v:\GitHub\los_angeles_quests\lib\features\presentation\pages\common\settings\payment_screen\cubit\payment_screen_cubit.dart", "Dart", 12, 0, 5, 17
"v:\GitHub\los_angeles_quests\lib\features\presentation\pages\common\settings\payment_screen\cubit\payment_screen_state.dart", "Dart", 8, 0, 5, 13
"v:\GitHub\los_angeles_quests\lib\features\presentation\pages\common\settings\payment_screen\payment_screen.dart", "Dart", 78, 1, 3, 82
"v:\GitHub\los_angeles_quests\lib\features\presentation\pages\common\settings\payment_screen\payment_screen_controller.dart", "Dart", 21, 0, 2, 23
"v:\GitHub\los_angeles_quests\lib\features\presentation\pages\common\settings\settings_screen\components\change_role_widget.dart", "Dart", 52, 0, 4, 56
"v:\GitHub\los_angeles_quests\lib\features\presentation\pages\common\settings\settings_screen\components\language_body.dart", "Dart", 88, 1, 11, 100
"v:\GitHub\los_angeles_quests\lib\features\presentation\pages\common\settings\settings_screen\components\my_credits_view\exchange_body.dart", "Dart", 63, 0, 5, 68
"v:\GitHub\los_angeles_quests\lib\features\presentation\pages\common\settings\settings_screen\components\my_credits_view\exchange_choice_body.dart", "Dart", 34, 0, 3, 37
"v:\GitHub\los_angeles_quests\lib\features\presentation\pages\common\settings\settings_screen\components\my_credits_view\exchange_item.dart", "Dart", 55, 0, 4, 59
"v:\GitHub\los_angeles_quests\lib\features\presentation\pages\common\settings\settings_screen\components\my_credits_view\my_credits_view.dart", "Dart", 85, 0, 3, 88
"v:\GitHub\los_angeles_quests\lib\features\presentation\pages\common\settings\settings_screen\components\settings_button.dart", "Dart", 43, 0, 4, 47
"v:\GitHub\los_angeles_quests\lib\features\presentation\pages\common\settings\settings_screen\components\settings_item.dart", "Dart", 31, 0, 4, 35
"v:\GitHub\los_angeles_quests\lib\features\presentation\pages\common\settings\settings_screen\components\subscription_payment_body.dart", "Dart", 91, 0, 8, 99
"v:\GitHub\los_angeles_quests\lib\features\presentation\pages\common\settings\settings_screen\components\try_our_new_subscription_body.dart", "Dart", 49, 0, 5, 54
"v:\GitHub\los_angeles_quests\lib\features\presentation\pages\common\settings\settings_screen\cubit\settings_screen_cubit.dart", "Dart", 22, 0, 4, 26
"v:\GitHub\los_angeles_quests\lib\features\presentation\pages\common\settings\settings_screen\cubit\settings_screen_state.dart", "Dart", 11, 0, 6, 17
"v:\GitHub\los_angeles_quests\lib\features\presentation\pages\common\settings\settings_screen\settings_screen.dart", "Dart", 172, 1, 6, 179
"v:\GitHub\los_angeles_quests\lib\features\presentation\pages\common\settings\settings_screen\settings_screen_controller.dart", "Dart", 228, 0, 10, 238
"v:\GitHub\los_angeles_quests\lib\features\presentation\pages\home_screen\controller\home_screen_controller.dart", "Dart", 128, 29, 6, 163
"v:\GitHub\los_angeles_quests\lib\features\presentation\pages\home_screen\cubit\home_screen_cubit.dart", "Dart", 77, 0, 16, 93
"v:\GitHub\los_angeles_quests\lib\features\presentation\pages\home_screen\cubit\home_screen_state.dart", "Dart", 9, 0, 6, 15
"v:\GitHub\los_angeles_quests\lib\features\presentation\pages\home_screen\home_screen.dart", "Dart", 131, 2, 8, 141
"v:\GitHub\los_angeles_quests\lib\features\presentation\pages\login\components\back_icon_button.dart", "Dart", 23, 0, 4, 27
"v:\GitHub\los_angeles_quests\lib\features\presentation\pages\login\enter_the_code_screen\cubit\enter_the_code_screen_cubit.dart", "Dart", 144, 0, 17, 161
"v:\GitHub\los_angeles_quests\lib\features\presentation\pages\login\enter_the_code_screen\cubit\enter_the_code_screen_state.dart", "Dart", 16, 0, 7, 23
"v:\GitHub\los_angeles_quests\lib\features\presentation\pages\login\enter_the_code_screen\enter_the_code_screen.dart", "Dart", 148, 1, 5, 154
"v:\GitHub\los_angeles_quests\lib\features\presentation\pages\login\forget_password_screen\cubit\forget_password_screen_cubit.dart", "Dart", 63, 0, 10, 73
"v:\GitHub\los_angeles_quests\lib\features\presentation\pages\login\forget_password_screen\cubit\forget_password_screen_state.dart", "Dart", 16, 0, 7, 23
"v:\GitHub\los_angeles_quests\lib\features\presentation\pages\login\forget_password_screen\forget_password_screen.dart", "Dart", 135, 0, 3, 138
"v:\GitHub\los_angeles_quests\lib\features\presentation\pages\login\language_screen\components\language_item.dart", "Dart", 64, 0, 4, 68
"v:\GitHub\los_angeles_quests\lib\features\presentation\pages\login\language_screen\components\language_selection.dart", "Dart", 37, 0, 4, 41
"v:\GitHub\los_angeles_quests\lib\features\presentation\pages\login\language_screen\language_screen.dart", "Dart", 81, 0, 4, 85
"v:\GitHub\los_angeles_quests\lib\features\presentation\pages\login\login_screen\components\remember_user.dart", "Dart", 75, 0, 7, 82
"v:\GitHub\los_angeles_quests\lib\features\presentation\pages\login\login_screen\cubit\login_screen_cubit.dart", "Dart", 151, 0, 17, 168
"v:\GitHub\los_angeles_quests\lib\features\presentation\pages\login\login_screen\cubit\login_screen_state.dart", "Dart", 20, 0, 7, 27
"v:\GitHub\los_angeles_quests\lib\features\presentation\pages\login\login_screen\log_in_screen.dart", "Dart", 212, 0, 3, 215
"v:\GitHub\los_angeles_quests\lib\features\presentation\pages\login\new_password_screen\cubit\new_password_screen_cubit.dart", "Dart", 71, 0, 10, 81
"v:\GitHub\los_angeles_quests\lib\features\presentation\pages\login\new_password_screen\cubit\new_password_screen_state.dart", "Dart", 16, 0, 7, 23
"v:\GitHub\los_angeles_quests\lib\features\presentation\pages\login\new_password_screen\new_password_screen.dart", "Dart", 181, 0, 4, 185
"v:\GitHub\los_angeles_quests\lib\features\presentation\pages\login\sign_in_screen\cubit\sign_in_screen_cubit.dart", "Dart", 105, 0, 12, 117
"v:\GitHub\los_angeles_quests\lib\features\presentation\pages\login\sign_in_screen\cubit\sign_in_screen_state.dart", "Dart", 16, 0, 7, 23
"v:\GitHub\los_angeles_quests\lib\features\presentation\pages\login\sign_in_screen\sign_in_scrreen.dart", "Dart", 375, 5, 3, 383
"v:\GitHub\los_angeles_quests\lib\features\presentation\pages\login\start_screen.dart", "Dart", 68, 0, 3, 71
"v:\GitHub\los_angeles_quests\lib\features\presentation\pages\user\artifacts_screen\artifacts_screen.dart", "Dart", 85, 0, 4, 89
"v:\GitHub\los_angeles_quests\lib\features\presentation\pages\user\artifacts_screen\components\artifacts\artifact_item.dart", "Dart", 49, 0, 4, 53
"v:\GitHub\los_angeles_quests\lib\features\presentation\pages\user\artifacts_screen\components\artifacts\artifact_view.dart", "Dart", 36, 0, 5, 41
"v:\GitHub\los_angeles_quests\lib\features\presentation\pages\user\artifacts_screen\components\artifacts\artifacts_view.dart", "Dart", 47, 0, 6, 53
"v:\GitHub\los_angeles_quests\lib\features\presentation\pages\user\artifacts_screen\components\features\feature_item.dart", "Dart", 33, 0, 4, 37
"v:\GitHub\los_angeles_quests\lib\features\presentation\pages\user\artifacts_screen\components\features\features_view.dart", "Dart", 53, 0, 5, 58
"v:\GitHub\los_angeles_quests\lib\features\presentation\pages\user\artifacts_screen\components\files\file_item.dart", "Dart", 54, 0, 5, 59
"v:\GitHub\los_angeles_quests\lib\features\presentation\pages\user\artifacts_screen\components\files\files_view.dart", "Dart", 34, 0, 4, 38
"v:\GitHub\los_angeles_quests\lib\features\presentation\pages\user\artifacts_screen\components\forward_button.dart", "Dart", 22, 0, 4, 26
"v:\GitHub\los_angeles_quests\lib\features\presentation\pages\user\artifacts_screen\components\tools\tool_item.dart", "Dart", 57, 0, 4, 61
"v:\GitHub\los_angeles_quests\lib\features\presentation\pages\user\artifacts_screen\components\tools\tool_item_count_parts.dart", "Dart", 34, 0, 5, 39
"v:\GitHub\los_angeles_quests\lib\features\presentation\pages\user\artifacts_screen\components\tools\tool_view.dart", "Dart", 63, 0, 5, 68
"v:\GitHub\los_angeles_quests\lib\features\presentation\pages\user\artifacts_screen\components\tools\tools_view.dart", "Dart", 67, 0, 6, 73
"v:\GitHub\los_angeles_quests\lib\features\presentation\pages\user\artifacts_screen\cubit\artifacts_screen_cubit.dart", "Dart", 56, 0, 7, 63
"v:\GitHub\los_angeles_quests\lib\features\presentation\pages\user\artifacts_screen\cubit\artifacts_screen_state.dart", "Dart", 27, 0, 13, 40
"v:\GitHub\los_angeles_quests\lib\features\presentation\pages\user\completing_quest_screen\completing_quest_screen.dart", "Dart", 83, 1, 4, 88
"v:\GitHub\los_angeles_quests\lib\features\presentation\pages\user\completing_quest_screen\components\action_panel.dart", "Dart", 41, 0, 3, 44
"v:\GitHub\los_angeles_quests\lib\features\presentation\pages\user\completing_quest_screen\components\buddy_hint_view.dart", "Dart", 68, 0, 4, 72
"v:\GitHub\los_angeles_quests\lib\features\presentation\pages\user\completing_quest_screen\components\close_button.dart", "Dart", 22, 0, 3, 25
"v:\GitHub\los_angeles_quests\lib\features\presentation\pages\user\completing_quest_screen\components\complete_quest_gradient_view.dart", "Dart", 44, 0, 4, 48
"v:\GitHub\los_angeles_quests\lib\features\presentation\pages\user\completing_quest_screen\components\current_quest_view.dart", "Dart", 36, 0, 3, 39
"v:\GitHub\los_angeles_quests\lib\features\presentation\pages\user\completing_quest_screen\components\custom_snapping_bottom_sheet\custom_snapping_bottom_header.dart", "Dart", 36, 0, 3, 39
"v:\GitHub\los_angeles_quests\lib\features\presentation\pages\user\completing_quest_screen\components\custom_snapping_bottom_sheet\custom_snapping_bottom_sheet.dart", "Dart", 73, 0, 4, 77
"v:\GitHub\los_angeles_quests\lib\features\presentation\pages\user\completing_quest_screen\components\custom_snapping_bottom_sheet\no_complete_point_suffix_view.dart", "Dart", 37, 0, 4, 41
"v:\GitHub\los_angeles_quests\lib\features\presentation\pages\user\completing_quest_screen\components\custom_snapping_bottom_sheet\point_item.dart", "Dart", 49, 0, 5, 54
"v:\GitHub\los_angeles_quests\lib\features\presentation\pages\user\completing_quest_screen\components\custom_snapping_bottom_sheet\points_list.dart", "Dart", 29, 0, 5, 34
"v:\GitHub\los_angeles_quests\lib\features\presentation\pages\user\completing_quest_screen\components\custom_snapping_bottom_sheet\right_now_view.dart", "Dart", 31, 0, 3, 34
"v:\GitHub\los_angeles_quests\lib\features\presentation\pages\user\completing_quest_screen\components\toolbar.dart", "Dart", 93, 0, 4, 97
"v:\GitHub\los_angeles_quests\lib\features\presentation\pages\user\completing_quest_screen\components\toolbar_circle.dart", "Dart", 26, 0, 3, 29
"v:\GitHub\los_angeles_quests\lib\features\presentation\pages\user\completing_quest_screen\components\toolbar_circle_ring.dart", "Dart", 20, 0, 4, 24
"v:\GitHub\los_angeles_quests\lib\features\presentation\pages\user\completing_quest_screen\components\toolbar_item.dart", "Dart", 58, 0, 4, 62
"v:\GitHub\los_angeles_quests\lib\features\presentation\pages\user\completing_quest_screen\cubit\artifacts_screen_cubit.dart", "Dart", 15, 0, 5, 20
"v:\GitHub\los_angeles_quests\lib\features\presentation\pages\user\completing_quest_screen\cubit\artifacts_screen_state.dart", "Dart", 8, 0, 5, 13
"v:\GitHub\los_angeles_quests\lib\features\presentation\pages\user\friends\friends_screen\components\friend_item.dart", "Dart", 75, 0, 4, 79
"v:\GitHub\los_angeles_quests\lib\features\presentation\pages\user\friends\friends_screen\components\friends_add_friend_body.dart", "Dart", 48, 0, 3, 51
"v:\GitHub\los_angeles_quests\lib\features\presentation\pages\user\friends\friends_screen\components\friends_view.dart", "Dart", 27, 0, 4, 31
"v:\GitHub\los_angeles_quests\lib\features\presentation\pages\user\friends\friends_screen\components\invite_friend_button.dart", "Dart", 18, 0, 4, 22
"v:\GitHub\los_angeles_quests\lib\features\presentation\pages\user\friends\friends_screen\components\requests_button.dart", "Dart", 24, 0, 4, 28
"v:\GitHub\los_angeles_quests\lib\features\presentation\pages\user\friends\friends_screen\cubit\friends_screen_cubit.dart", "Dart", 13, 0, 5, 18
"v:\GitHub\los_angeles_quests\lib\features\presentation\pages\user\friends\friends_screen\cubit\friends_screen_state.dart", "Dart", 14, 0, 8, 22
"v:\GitHub\los_angeles_quests\lib\features\presentation\pages\user\friends\friends_screen\friends_screen.dart", "Dart", 94, 0, 4, 98
"v:\GitHub\los_angeles_quests\lib\features\presentation\pages\user\friends\friends_screen\friends_screen_controller.dart", "Dart", 20, 0, 2, 22
"v:\GitHub\los_angeles_quests\lib\features\presentation\pages\user\friends\requests_screen\components\empty_requests_view.dart", "Dart", 20, 0, 3, 23
"v:\GitHub\los_angeles_quests\lib\features\presentation\pages\user\friends\requests_screen\cubit\friends_screen_cubit.dart", "Dart", 13, 0, 5, 18
"v:\GitHub\los_angeles_quests\lib\features\presentation\pages\user\friends\requests_screen\cubit\friends_screen_state.dart", "Dart", 14, 0, 8, 22
"v:\GitHub\los_angeles_quests\lib\features\presentation\pages\user\friends\requests_screen\requests_screen.dart", "Dart", 49, 0, 3, 52
"v:\GitHub\los_angeles_quests\lib\features\presentation\pages\user\invite_friend_screen\components\exclude_friend_view.dart", "Dart", 55, 0, 3, 58
"v:\GitHub\los_angeles_quests\lib\features\presentation\pages\user\invite_friend_screen\components\invite_friend_item.dart", "Dart", 62, 0, 7, 69
"v:\GitHub\los_angeles_quests\lib\features\presentation\pages\user\invite_friend_screen\components\invite_friend_list.dart", "Dart", 47, 0, 5, 52
"v:\GitHub\los_angeles_quests\lib\features\presentation\pages\user\invite_friend_screen\components\success_view.dart", "Dart", 28, 0, 3, 31
"v:\GitHub\los_angeles_quests\lib\features\presentation\pages\user\invite_friend_screen\cubit\invite_friend_cubit.dart", "Dart", 35, 0, 9, 44
"v:\GitHub\los_angeles_quests\lib\features\presentation\pages\user\invite_friend_screen\cubit\invite_friend_state.dart", "Dart", 9, 0, 6, 15
"v:\GitHub\los_angeles_quests\lib\features\presentation\pages\user\invite_friend_screen\invite_friend_screen.dart", "Dart", 101, 0, 3, 104
"v:\GitHub\los_angeles_quests\lib\features\presentation\pages\user\orbital_radar_screen\components\hint_button.dart", "Dart", 21, 0, 4, 25
"v:\GitHub\los_angeles_quests\lib\features\presentation\pages\user\orbital_radar_screen\orbital_radar_screen.dart", "Dart", 55, 0, 3, 58
"v:\GitHub\los_angeles_quests\lib\features\presentation\pages\user\present_credits_screen\components\choose_card_body.dart", "Dart", 165, 12, 7, 184
"v:\GitHub\los_angeles_quests\lib\features\presentation\pages\user\present_credits_screen\components\present_credits_body.dart", "Dart", 92, 0, 5, 97
"v:\GitHub\los_angeles_quests\lib\features\presentation\pages\user\present_credits_screen\cubit\present_credits_screen_cubit.dart", "Dart", 12, 0, 4, 16
"v:\GitHub\los_angeles_quests\lib\features\presentation\pages\user\present_credits_screen\cubit\present_credits_screen_state.dart", "Dart", 14, 0, 8, 22
"v:\GitHub\los_angeles_quests\lib\features\presentation\pages\user\present_credits_screen\present_credits_screen.dart", "Dart", 71, 0, 3, 74
"v:\GitHub\los_angeles_quests\lib\features\presentation\pages\user\tools_screen\components\tools_carousel.dart", "Dart", 49, 0, 3, 52
"v:\GitHub\los_angeles_quests\lib\features\presentation\pages\user\tools_screen\components\tools_carousel_item.dart", "Dart", 33, 0, 3, 36
"v:\GitHub\los_angeles_quests\lib\features\presentation\pages\user\tools_screen\tools_screen.dart", "Dart", 54, 0, 3, 57
"v:\GitHub\los_angeles_quests\lib\features\presentation\splash_screen\cubit\splash_screen_cubit.dart", "Dart", 58, 0, 7, 65
"v:\GitHub\los_angeles_quests\lib\features\presentation\splash_screen\cubit\splash_screen_state.dart", "Dart", 12, 0, 6, 18
"v:\GitHub\los_angeles_quests\lib\features\presentation\splash_screen\splash_screen.dart", "Dart", 61, 0, 3, 64
"v:\GitHub\los_angeles_quests\lib\features\presentation\widgets\blur_rectangle_view.dart", "Dart", 23, 0, 3, 26
"v:\GitHub\los_angeles_quests\lib\features\presentation\widgets\bottom_navigation_bar_tile.dart", "Dart", 64, 0, 4, 68
"v:\GitHub\los_angeles_quests\lib\features\presentation\widgets\button_chips\button_chip.dart", "Dart", 36, 0, 4, 40
"v:\GitHub\los_angeles_quests\lib\features\presentation\widgets\button_chips\button_chips_view.dart", "Dart", 29, 0, 4, 33
"v:\GitHub\los_angeles_quests\lib\features\presentation\widgets\custom_app_bar.dart", "Dart", 53, 0, 4, 57
"v:\GitHub\los_angeles_quests\lib\features\presentation\widgets\custom_bottom_sheet_template\cubit\custom_bottom_sheet_template_cubit.dart", "Dart", 35, 0, 7, 42
"v:\GitHub\los_angeles_quests\lib\features\presentation\widgets\custom_bottom_sheet_template\cubit\custom_bottom_sheet_template_state.dart", "Dart", 9, 0, 5, 14
"v:\GitHub\los_angeles_quests\lib\features\presentation\widgets\custom_bottom_sheet_template\custom_bottom_sheet_template.dart", "Dart", 196, 0, 9, 205
"v:\GitHub\los_angeles_quests\lib\features\presentation\widgets\custom_button.dart", "Dart", 94, 2, 4, 100
"v:\GitHub\los_angeles_quests\lib\features\presentation\widgets\custom_loading_indicator.dart", "Dart", 10, 0, 3, 13
"v:\GitHub\los_angeles_quests\lib\features\presentation\widgets\custom_search_view.dart", "Dart", 222, 2, 27, 251
"v:\GitHub\los_angeles_quests\lib\features\presentation\widgets\custom_text_error_widget.dart", "Dart", 14, 0, 4, 18
"v:\GitHub\los_angeles_quests\lib\features\presentation\widgets\custom_text_field\cubit\custom_text_field_cubit.dart", "Dart", 41, 0, 5, 46
"v:\GitHub\los_angeles_quests\lib\features\presentation\widgets\custom_text_field\cubit\custom_text_field_state.dart", "Dart", 10, 0, 4, 14
"v:\GitHub\los_angeles_quests\lib\features\presentation\widgets\custom_text_field\custom_text_field.dart", "Dart", 315, 0, 11, 326
"v:\GitHub\los_angeles_quests\lib\features\presentation\widgets\gradient_card.dart", "Dart", 84, 0, 4, 88
"v:\GitHub\los_angeles_quests\lib\features\presentation\widgets\name_chip_under_avatar.dart", "Dart", 38, 0, 4, 42
"v:\GitHub\los_angeles_quests\lib\features\presentation\widgets\quest_card_edit.dart", "Dart", 78, 0, 6, 84
"v:\GitHub\los_angeles_quests\lib\features\presentation\widgets\quest_preferences\quest_preference_view.dart", "Dart", 107, 0, 7, 114
"v:\GitHub\los_angeles_quests\lib\features\presentation\widgets\quest_preferences\quest_preference_view_item.dart", "Dart", 198, 5, 5, 208
"v:\GitHub\los_angeles_quests\lib\features\presentation\widgets\right_arrow_in_orange_circle.dart", "Dart", 26, 0, 4, 30
"v:\GitHub\los_angeles_quests\lib\features\repositories\purchase_repository.dart", "Dart", 4, 0, 1, 5
"v:\GitHub\los_angeles_quests\lib\features\repositories\purchase_repository_impl.dart", "Dart", 12, 2, 4, 18
"v:\GitHub\los_angeles_quests\lib\firebase_options.dart", "Dart", 53, 12, 4, 69
"v:\GitHub\los_angeles_quests\lib\l10n\L10n.dart", "Dart", 7, 0, 2, 9
"v:\GitHub\los_angeles_quests\lib\l10n\locale_keys.g.dart", "Dart", 248, 1, 3, 252
"v:\GitHub\los_angeles_quests\lib\locator_service.dart", "Dart", 274, 5, 12, 291
"v:\GitHub\los_angeles_quests\lib\main.dart", "Dart", 187, 2, 8, 197
"Total", "-", 21181, 177, 2213, 23571